TextAdventure
An Interactive Fiction by Wilcox Brothers
Release 1 / Serial number 150409 / Inform 7 build 6L38 (I6/v6.33 lib 6/12N) SD

The sun shines through the thin sheet of the tent. You're still in your sleeping bag and next to you lies Amanda Oliver in her own sleeping bag, still in deep sleep.

You can see your backpack (closed) here.

>look
Arboretum

>SHOWME
Gazebo - room
    yourself - person

>test
>--> No test scripts exist for this game.

* * *

TextAdventure
An Interactive Fiction by Wilcox Brothers
Release 1 / Serial number 150409 / Inform 7 build 6L38 (I6/v6.33 lib 6/12N) SD

The sun shines through the thin sheet of the tent. You're still in your sleeping bag and next to you lies Amanda Oliver in her own sleeping bag, still in deep sleep.

You can see your backpack (closed) here.

>of
That's not a verb I recognise.

>look
A magician's booth stands in the corner, painted dark blue with glittering gold stars.

Center Ring

>look the
(the magician's booth)
It is dark blue and glittering with gold stars. It has been firmly shut.

Center Ring

>look of
It is dark blue and glittering with gold stars. It has been firmly shut.

Center Ring

>look the
(the magician's booth)
It is dark blue and glittering with gold stars. It has been firmly shut.

Center Ring

* * *

>look of
It is dark blue and glittering with gold stars. It has been firmly shut.

Center Ring

>look door
It is dark blue and glittering with gold stars. It has been firmly shut.

Center Ring

>open door
You open the magician's booth.

Center Ring

>go inside
The door stands open to the outside.

Starry Void

>look
The door stands open to the outside.

Starry Void

>close
(the magician's booth)
You close the magician's booth.

Starry Void

>look
A crack of light indicates the way back out to the center ring.

Starry Void

>open door
You open the magician's booth.

Starry Void

>close of
You close the magician's booth.

Starry Void

>open of
You open the magician's booth.

Starry Void

>examine crack of light
The booth door is wide open.

Starry Void

>enter door
A magician's booth stands in the corner, painted dark blue with glittering gold stars.

Center Ring

* * *

TextAdventure
An Interactive Fiction by Wilcox Brothers
Release 1 / Serial number 150409 / Inform 7 build 6L38 (I6/v6.33 lib 6/12N) SD

The sun shines through the thin sheet of the tent. You're still in your sleeping bag and next to you lies Amanda Oliver in her own sleeping bag, still in deep sleep.

You can see your backpack (closed) here.

>look chaps
You can't use multiple objects with that verb.

>look chap
Who do you mean, Lewis or Harper?

>look Lewis
A wiry, excitable engineer who just signed aboard last week.

Crew Lounge

>l Harper
Harper's a good guy: taciturn when sober, affectionate when drunk, but rarely annoying in either state.

Crew Lounge

>l holo
The air above the projector is disappointingly clear.

The holographic projector is currently switched off.

Crew Lounge

>turn on holo
You switch the holographic projector on.

Crew Lounge

>l holo
The projector is now playing a documentary about the early politics of the Mars colony.

The holographic projector is currently switched on.

Crew Lounge

* * *

TextAdventure
An Interactive Fiction by Wilcox Brothers
Release 1 / Serial number 150409 / Inform 7 build 6L38 (I6/v6.33 lib 6/12N) SD

The sun shines through the thin sheet of the tent. You're still in your sleeping bag and next to you lies Amanda Oliver in her own sleeping bag, still in deep sleep.

You can see your backpack (closed) here.

>take backpack
Taken.

Tent

>look
The sun shines through the thin sheet of the tent. You're still in your sleeping bag and next to you lies Amanda Oliver in her own sleeping bag, still deeply asleep.

Tent

* * *

TextAdventure
An Interactive Fiction by Wilcox Brothers
Release 1 / Serial number 150409 / Inform 7 build 6L38 (I6/v6.33 lib 6/12N) SD

The sun shines through the thin sheet of the tent. You're still in your sleeping bag and next to you lies Amanda Oliver in her own sleeping bag, still in deep sleep.

You can see your backpack (closed) here.

>look backpack
It's the backpack you brought with you but it looks like someone should have left it behind in the 90"s. It's the only fitting thing you could find in the attic back home.

Tent

* * *

TextAdventure
An Interactive Fiction by Wilcox Brothers
Release 1 / Serial number 150409 / Inform 7 build 6L38 (I6/v6.33 lib 6/12N) SD

The sun shines through the thin sheet of the tent. You're still in your sleeping bag and next to you lies Amanda Oliver in her own sleeping bag, still in deep sleep.

You can see your backpack (closed) here.

>open backpack
You open your backpack, revealing a watch and a wallet.

Tent

>look
The sun shines through the thin sheet of the tent. You're still in your sleeping bag and next to you lies Amanda Oliver in her own sleeping bag, still deeply asleep.

You can see your backpack (closed) here.

Tent

>look backpack
You see nothing special about your backpack.

Tent

* * *

>open backpack
You open your backpack, revealing a watch and a wallet.

Tent

>look backpack
At the head of your sleeping bag is your backpack, right next to Amandas.

In your backpack are a watch and a wallet.

Tent

* * *

TextAdventure
An Interactive Fiction by Wilcox Brothers
Release 1 / Serial number 150409 / Inform 7 build 6L38 (I6/v6.33 lib 6/12N) SD

The sun shines through the thin sheet of the tent. You're still in your sleeping bag and next to you lies Amanda Oliver in her own sleeping bag, still in deep sleep.

You can see your backpack (closed) here.

>go outside
You can't go that way.

Tent

>go inside
Campground

>look backpack
You can't see any such thing.